209,210,210,210,210,210,210,211
212,208,252,93,64,208,208,213
214,215,215,215,215,215,215,216
209,210,210,210,210,210,210,211
212,208,208,208,208,208,208,213
212,87,88,90,64,208,208,213
212,208,91,97,92,93,102,213
212,208,208,208,208,208,208,213
212,208,208,208,208,208,208,213
212,208,208,81,208,208,64,213
212,208,208,208,208,208,208,213
212,208,222,89,220,221,208,213
212,208,208,208,208,208,208,213
214,215,215,215,215,215,215,216
,