209,210,210,210,210,210,210,211
212,208,79,80,81,82,208,213
214,215,215,215,215,215,215,216
209,210,210,210,210,210,210,211
212,208,208,208,208,208,208,213
212,79,80,81,82,208,208,213
212,83,84,85,86,87,208,213
212,208,208,208,208,208,208,213
212,208,208,208,208,208,208,213
212,208,208,88,208,208,64,213
212,208,208,208,208,208,208,213
212,208,222,89,220,221,208,213
212,208,208,208,208,208,208,213
214,215,215,215,215,215,215,216
,