209,210,210,210,210,210,210,211
212,208,66,95,235,208,208,213
214,215,215,215,215,215,215,216
209,210,210,210,210,210,210,211
212,208,208,208,208,208,208,213
212,66,95,235,234,208,208,213
212,208,99,100,96,101,102,213
212,208,208,208,208,208,208,213
212,208,208,208,208,208,208,213
212,208,208,81,208,208,82,213
212,208,208,208,208,208,208,213
212,208,222,89,220,221,208,213
212,208,208,208,208,208,208,213
214,215,215,215,215,215,215,216
,