209,210,210,210,210,210,210,211
212,65,66,67,68,69,208,213
214,215,215,215,215,215,215,216
208,70,71,72,73,72,74,208
208,208,208,208,208,208,208,208
208,79,80,81,82,83,84,85
208,208,208,208,208,208,208,208
208,86,87,72,208,208,208,208
208,208,208,208,208,208,208,208
208,88,89,79,84,90,91,92
208,208,208,208,208,208,208,208
208,217,218,219,208,208,208,208
223,89,217,218,219
,