136,128,129,129,129,129,129,129,129,129,129,129,129,129,129,129,129,129,130,136
137,131,0,0,0,0,0,0,0,0,0,0,0,0,0,0,0,0,132,137
138,131,0,0,0,0,0,0,0,0,0,0,0,0,0,0,0,0,132,138
140,131,0,0,0,0,0,0,0,0,0,0,0,0,0,0,0,0,132,140
140,131,0,0,0,0,0,0,0,0,0,0,0,0,0,0,0,0,132,140
139,133,134,134,134,134,134,134,134,134,134,134,134,134,134,134,134,134,135,139
