0,212,208,208,208,208,213,0
0,214,215,215,215,215,216,0
0,209,210,210,210,210,211,0
0,212,208,208,208,208,213,0
0,214,215,215,215,215,216,0
0,209,210,210,210,210,211,0
0,212,208,208,208,208,213,0
0,214,215,215,215,215,216,0
0,209,210,210,210,210,211,0
,