212,208,208,81,208,208,82,213
212,208,208,208,208,208,208,213
212,64,65,66,67,68,69,213
212,208,208,208,208,95,107,213
212,208,208,238,208,208,208,213
,