29,1,2,3,1,2,3,1,2,3
1,5,0,31,2,2,2,2,2,2,2,2,2,2,2,2,2,2,2,3
4,0,0,0,0,0,0,0,0,0,0,0,0,0,0,0,0,0,0,6
4,20,21,0,0,0,0,0,0,0,0,0,0,0,0,0,0,0,0,6
4,0,0,0,0,0,0,0,0,0,0,0,0,0,0,0,0,0,0,6
4,0,0,0,0,0,0,0,85,86,87,88,89,90,91,92,0,0,0,6
4,10,11,0,0,0,0,0,0,0,18,19,0,0,0,0,0,0,0,6
4,12,13,0,0,0,0,0,0,0,16,17,0,0,0,60,0,0,0,6
7,8,8,8,8,8,8,8,8,8,8,8,8,8,8,8,8,8,8,9

