209,210,210,210,210,210,210,211
212,208,72,96,97,208,208,213
214,215,215,215,215,215,215,216
209,210,210,210,210,210,210,211
212,68,108,109,111,64,64,213
212,64,244,96,97,110,64,213
212,64,64,64,64,64,64,213
212,64,112,113,64,64,64,213
212,64,64,64,64,64,64,213
212,64,253,241,64,64,64,213
212,64,64,64,64,64,64,213
214,215,215,215,215,215,215,216
,