29,1,2,3,1,2,3,1,2,3
1,2,2,2,5,0,31,2,2,2,2,2,2,2,2,2,2,2,2,3
4,0,0,0,0,0,0,0,0,0,0,0,0,0,0,0,0,0,0,6
4,64,65,66,67,0,0,0,0,0,74,75,68,69,0,0,0,0,0,6
4,0,0,0,0,0,0,0,0,0,0,0,0,0,0,0,0,0,0,6
4,68,69,70,76,0,0,0,0,0,74,75,72,69,0,0,0,0,0,6
4,0,0,0,0,0,0,0,0,0,0,0,0,0,0,0,0,0,0,6
4,72,69,71,73,0,0,0,0,0,0,0,0,0,0,0,0,0,0,6
7,8,8,8,8,8,8,8,8,8,8,8,8,8,8,8,8,8,8,9

