209,210,210,210,210,210,210,211
212,208,250,107,108,208,208,213
214,215,215,215,215,215,215,216
82,82,82,82,82,82,82,82
82,82,82,82,82,82,82,82
82,82,82,82,82,82,82,82
82,82,82,82,82,82,82,82
82,82,82,82,82,82,82,82
82,82,82,82,82,82,82,82
82,82,82,82,82,82,82,82
82,82,82,82,82,82,82,82
90,91,92,82,82,93,94,95

