209,210,210,210,210,210,210,211
212,208,72,96,97,208,208,213
214,215,215,215,215,215,215,216
209,210,210,210,210,210,210,211
212,64,64,64,64,64,64,213
212,64,64,64,64,64,64,213
212,64,64,64,64,64,64,213
212,64,72,115,116,64,64,213
212,64,64,64,64,64,64,213
212,64,64,64,64,64,64,213
212,64,64,64,64,64,64,213
214,215,215,215,215,215,215,216
,