209,210,210,210,210,210,210,211
212,208,121,79,122,208,208,213
214,215,215,215,215,215,215,216
209,210,210,210,210,210,210,211
212,121,79,122,64,64,64,213
212,64,100,98,94,95,110,213
212,64,64,64,64,64,64,213
212,64,65,93,64,64,64,213
212,64,64,64,64,64,64,213
212,64,93,93,96,64,64,213
212,64,64,64,64,64,64,213
214,215,215,215,215,215,215,216

