209,210,210,210,210,210,210,211
212,64,253,101,93,208,208,213
214,215,215,215,215,215,215,216
208,208,208,208,208,208,208,208
208,208,208,208,208,208,208,208
208,87,88,90,64,208,208,208
208,208,109,94,100,101,93,102
208,208,208,208,208,208,208,208
208,208,208,208,208,208,208,208
120,121,122,123,124,125,126,127
79,79,79,79,79,79,79,79
208,208,208,208,208,208,208,208
208,208,208,208,208,208,208,208
106,107,108,97,208,208,220,221
,