209,210,210,210,210,210,210,211
212,208,121,79,122,208,208,213
214,215,215,215,215,215,215,216
209,210,210,210,210,210,210,211
212,64,64,64,64,64,64,213
212,64,64,64,64,64,64,213
212,64,64,64,64,64,64,213
212,121,79,122,123,92,94,213
212,64,64,64,64,64,64,213
212,64,64,64,64,64,64,213
212,64,64,64,64,64,64,213
214,215,215,215,215,215,215,216
