209,210,210,210,210,210,210,211
212,208,97,98,96,208,208,213
214,215,215,215,215,215,215,216
208,208,208,208,208,208,208,208
208,208,208,208,208,208,208,208
208,97,98,96,234,208,208,208
208,208,208,99,100,96,101,102
208,208,208,208,208,208,208,208
208,208,208,208,208,208,208,208
120,121,122,123,124,125,126,127
79,79,79,79,79,79,79,79
208,208,208,208,208,208,208,208
208,208,208,208,208,208,208,208
106,107,108,97,208,208,220,221
,