209,210,210,210,210,210,210,211
212,224,225,226,227,228,229,213
214,215,215,215,215,215,215,216
208,208,208,208,208,208,208,208
208,208,208,208,208,208,208,208
112,113,114,115,116,117,118,119
208,208,208,230,208,208,208,208
224,225,226,227,228,229,65,110
208,208,208,208,208,208,208,208
209,210,210,210,210,210,210,211
212,120,121,122,123,124,125,213
212,79,79,79,79,79,79,213
214,215,215,215,215,215,215,216
106,107,108,97,208,208,220,221
,