209,210,210,210,210,210,210,211
212,224,225,226,101,93,64,213
214,215,215,215,215,215,215,216
208,208,208,208,208,208,208,208
208,208,208,208,208,208,208,208
64,87,88,90,100,101,93,64
208,208,208,227,228,208,208,208
112,113,114,115,116,117,118,119
208,208,208,208,208,208,208,208
209,210,210,210,210,210,210,211
212,120,121,122,123,124,125,213
212,79,79,79,79,79,79,213
214,215,215,215,215,215,215,216
106,107,108,97,208,208,220,221
,