209,210,210,210,210,210,210,211
212,208,115,79,109,208,208,213
214,215,215,215,215,215,215,216
209,210,210,210,210,210,210,211
212,208,208,208,208,208,208,213
212,115,79,109,208,208,208,213
212,208,208,208,208,208,208,213
212,208,208,208,208,208,208,213
212,208,208,208,237,92,94,213
212,208,208,208,208,208,208,213
214,215,215,215,215,215,215,216
208,208,223,89,217,218,219,208
,