209,210,210,210,210,210,210,211
212,64,71,72,73,74,64,213
214,215,215,215,215,215,215,216
209,210,210,210,210,210,210,211
212,64,64,64,64,64,64,213
212,64,223,83,84,64,64,213
212,64,64,64,64,64,64,213
212,64,64,64,64,64,64,213
212,64,85,86,64,64,64,213
212,64,64,64,64,64,64,213
212,64,64,64,64,64,64,213
212,64,217,218,219,64,64,213
212,64,64,64,64,64,64,213
214,215,215,215,215,215,215,216
