209,210,210,210,210,210,210,211
212,208,82,69,77,78,208,213
214,215,215,215,215,215,215,216
209,210,210,210,210,210,210,211
212,208,208,208,208,208,208,213
212,208,82,105,208,208,208,213
212,208,208,208,208,208,208,213
212,208,106,239,97,208,208,213
212,208,208,208,208,208,208,213
212,208,119,120,250,208,208,213
212,208,208,208,208,208,208,213
214,215,215,215,215,215,215,216
,