1,1,1,1,1,1,1,1,1,1,1,1,1,1,1,1,1,1,1,1,0,0,0,0,0,0,0,0,0,0,0,0
1,1,1,1,1,1,1,1,1,1,1,1,1,1,1,1,1,1,1,1,0,0,0,0,0,0,0,0,0,0,0,0
0,0,2,3,4,5,6,7,8,9,0,0,0,0,0,0,0,0,0,0,0,0,0,0,0,0,0,0,0,0,0,0
0,0,10,11,12,13,14,15,15,16,17,0,0,0,0,0,0,0,0,0,0,0,0,0,0,0,0,0,0,0,0,0
18,19,20,21,15,22,23,24,25,26,27,0,0,0,0,0,0,0,0,0,0,0,0,0,0,0,0,0,0,0,0,0
28,29,30,31,32,33,34,35,36,37,38,0,0,0,0,0,0,0,0,0,0,0,0,0,0,0,0,0,0,0,0,0
0,39,40,41,42,43,44,45,46,47,48,0,0,0,0,0,0,0,49,50,0,0,0,0,0,0,0,0,0,0,0,0
51,0,0,0,52,53,54,55,56,0,0,0,0,57,58,59,18,60,61,62,0,0,0,0,0,0,0,0,0,0,0,0
63,64,65,66,67,68,69,70,71,72,73,74,75,76,77,78,79,80,81,82,0,0,0,0,0,0,0,0,0,0,0,0
1,83,84,85,86,87,88,89,90,81,91,92,93,94,95,96,97,98,99,100,0,0,0,0,0,0,0,0,0,0,0,0
1,101,102,15,103,104,105,106,107,108,81,109,110,111,112,113,114,115,116,117,0,0,0,0,0,0,0,0,0,0,0,0
1,1,118,119,120,121,122,123,124,125,81,126,127,128,129,130,131,132,133,134,0,0,0,0,0,0,0,0,0,0,0,0
1,1,1,1,1,1,1,1,135,136,137,138,0,139,140,141,142,143,144,145,0,0,0,0,0,0,0,0,0,0,0,0
1,1,1,1,1,1,1,1,1,1,1,1,1,1,1,1,1,1,1,1,0,0,0,0,0,0,0,0,0,0,0,0
1,1,1,1,1,1,1,1,1,1,1,1,1,1,1,1,1,1,1,1,0,0,0,0,0,0,0,0,0,0,0,0
1,1,1,1,1,1,1,1,1,1,1,1,1,1,1,1,1,1,1,1,0,0,0,0,0,0,0,0,0,0,0,0
1,1,1,1,1,1,1,1,1,1,1,1,1,1,1,1,1,1,1,1,0,0,0,0,0,0,0,0,0,0,0,0
1,1,1,1,1,1,1,1,1,1,1,1,1,1,1,1,1,1,1,1,0,0,0,0,0,0,0,0,0,0,0,0
