209,210,210,210,210,210,210,211
212,208,114,91,70,208,208,213
214,215,215,215,215,215,215,216
209,210,210,210,210,210,210,211
212,208,208,208,208,208,208,213
212,114,91,70,208,208,208,213
212,208,208,208,208,208,208,213
212,208,208,208,208,208,208,213
212,208,208,208,237,92,94,213
212,208,208,208,208,208,208,213
214,215,215,215,215,215,215,216
208,208,223,89,217,218,219,208

