209,210,210,210,210,210,210,211
212,208,111,112,113,208,208,213
214,215,215,215,215,215,215,216
209,210,210,210,210,210,210,211
212,208,208,208,208,208,208,213
212,208,240,241,242,109,208,213
212,208,208,208,208,208,208,213
212,208,247,248,66,249,208,213
212,208,208,208,208,208,208,213
212,208,250,115,116,208,208,213
212,208,208,208,208,208,208,213
214,215,215,215,215,215,215,216

