15,15,16,15,16,17,0,0,0,0,0,0,0,0,18,19,15,19,15,15,0,0,0,0,0,0,0,0,0,0,0,0
15,16,15,15,16,20,128,129,130,131,132,133,134,135,21,19,15,15,19,15,0,0,0,0,0,0,0,0,0,0,0,0
15,15,16,16,20,0,136,137,138,139,140,141,142,143,0,21,19,19,15,15,0,0,0,0,0,0,0,0,0,0,0,0
15,15,22,23,0,0,144,145,146,147,148,149,150,151,0,0,24,22,15,15,0,0,0,0,0,0,0,0,0,0,0,0
15,15,15,25,26,0,152,153,154,155,156,157,158,159,0,27,28,15,15,15,0,0,0,0,0,0,0,0,0,0,0,0
29,29,29,30,0,0,160,161,162,163,164,165,166,167,0,0,31,29,29,29,0,0,0,0,0,0,0,0,0,0,0,0
33,33,33,34,0,0,168,169,170,171,172,173,174,175,0,0,35,33,33,33,0,0,0,0,0,0,0,0,0,0,0,0
36,36,37,38,38,0,176,177,178,179,180,181,182,183,0,38,38,39,36,36,0,0,0,0,0,0,0,0,0,0,0,0
