15,16,17,18,19,20,0,0,0,0,0,0,0,0,21,22,23,24,16,15,0,0,0,0,0,0,0,0,0,0,0,0
15,16,17,18,19,20,128,129,130,131,132,133,134,135,21,22,23,24,16,15,0,0,0,0,0,0,0,0,0,0,0,0
15,16,17,18,19,20,136,137,138,139,140,141,142,143,21,22,23,24,16,15,0,0,0,0,0,0,0,0,0,0,0,0
15,16,17,18,19,20,144,145,146,147,148,149,150,151,21,22,23,24,16,15,0,0,0,0,0,0,0,0,0,0,0,0
15,16,17,18,19,20,152,153,154,155,156,157,158,159,21,22,23,24,16,15,0,0,0,0,0,0,0,0,0,0,0,0
25,25,26,26,27,28,160,161,162,163,164,165,166,167,28,27,29,29,25,25,0,0,0,0,0,0,0,0,0,0,0,0
30,31,32,33,34,35,168,169,170,171,172,173,174,175,36,33,34,37,31,30,0,0,0,0,0,0,0,0,0,0,0,0
30,30,31,32,33,34,176,177,178,179,180,181,182,183,33,34,37,31,30,30,0,0,0,0,0,0,0,0,0,0,0,0
