29,1,2,3,1,2,3,1,2,3
1,2,2,2,2,2,2,5,0,31,2,2,2,2,2,2,2,2,2,3
4,0,0,0,0,0,224,225,226,227,228,229,0,0,0,0,0,0,0,6
4,0,0,0,0,0,0,0,0,0,0,0,0,0,0,0,0,0,0,6
4,184,185,186,187,188,189,190,191,0,200,201,202,203,204,205,206,207,0,6
4,0,0,0,0,0,0,0,0,0,0,0,0,0,0,0,0,0,0,6
4,192,193,194,195,196,197,198,199,0,208,209,210,211,212,213,214,215,0,6
4,0,0,0,0,0,0,0,0,0,0,0,0,0,0,0,0,0,0,6
7,8,8,8,8,8,8,8,8,8,8,8,8,8,8,8,8,8,8,9
,