15,16,15,16,18,0,0,0,0,0,0,0,0,0,0,19,20,21,20,21,0,0,0,0,0,0,0,0,0,0,0,0
15,22,15,22,23,0,128,129,130,131,132,133,134,135,0,24,25,21,25,21,0,0,0,0,0,0,0,0,0,0,0,0
15,22,15,22,23,0,136,137,138,139,140,141,142,143,0,24,25,21,25,21,0,0,0,0,0,0,0,0,0,0,0,0
15,22,15,22,23,0,144,145,146,147,148,149,150,151,0,24,25,21,25,21,5,0,0,0,0,0,0,0,0,0,0,0
15,26,15,26,27,0,152,153,154,155,156,157,158,159,0,28,29,21,29,21,10,0,0,0,0,0,5,0,0,0,0,0
30,30,30,31,32,0,160,161,162,163,164,165,166,167,0,33,34,30,30,30,0,0,0,0,0,0,10,0,0,0,0,0
35,35,36,37,38,0,168,169,170,171,172,173,174,175,0,39,40,41,35,35,0,0,0,0,0,0,0,0,0,0,0,0
35,36,37,42,43,0,176,177,178,179,180,181,182,183,0,44,45,40,41,35,0,0,0,0,0,0,0,0,0,0,0,0
