15,15,15,15,15,16,46,46,46,46,46,46,46,46,17,15,15,15,15,15,0,0,0,0,0,0,0,0,0,0,0,0
18,18,18,18,18,19,128,129,130,131,132,133,134,135,20,18,18,18,18,18,0,0,0,0,0,0,0,0,0,0,0,0
21,21,21,21,22,46,136,137,138,139,140,141,142,143,46,23,21,21,21,21,0,0,0,0,0,0,0,0,0,0,0,0
24,25,26,24,27,46,144,145,146,147,148,149,150,151,46,28,24,25,29,30,0,0,0,0,0,0,0,0,0,0,0,0
31,32,32,31,33,46,152,153,154,155,156,157,158,159,46,34,35,36,36,35,0,0,0,0,0,0,0,0,0,0,0,0
37,37,37,16,46,46,160,161,162,163,164,165,166,167,46,46,17,37,37,37,0,0,0,0,0,0,0,0,0,0,0,0
38,38,38,39,46,46,168,169,170,171,172,173,174,175,46,46,40,41,41,41,0,0,0,0,0,0,0,0,0,0,0,0
42,42,42,43,46,46,176,177,178,179,180,181,182,183,46,46,44,45,45,45,0,0,0,0,0,0,0,0,0,0,0,0
