15,15,15,15,15,16,46,46,46,46,46,46,46,46,17,15,15,15,15,15,0,0,0,0,0,0,0,0,0,0,0,0
15,15,15,15,15,18,128,129,130,131,132,133,134,135,19,15,15,15,15,15,0,0,0,0,0,0,0,0,0,0,0,0
20,20,20,20,21,46,136,137,138,139,140,141,142,143,46,22,20,20,20,20,0,0,0,0,0,0,0,0,0,0,0,0
23,23,23,23,24,46,144,145,146,147,148,149,150,151,46,25,23,23,23,23,0,0,0,0,0,0,0,0,0,0,0,0
26,27,28,29,30,46,152,153,154,155,156,157,158,159,46,31,29,26,27,28,0,0,0,0,0,0,0,0,0,0,0,0
32,33,34,35,46,46,160,161,162,163,164,165,166,167,46,46,17,32,33,34,0,0,0,0,0,0,0,0,0,0,0,0
37,38,39,40,46,46,168,169,170,171,172,173,174,175,46,46,41,37,38,39,0,0,0,0,0,0,0,0,0,0,0,0
32,42,43,44,46,46,176,177,178,179,180,181,182,183,46,46,45,32,42,43,0,0,0,0,0,0,0,0,0,0,0,0
