15,16,17,18,15,19,46,46,46,46,46,46,46,46,20,21,22,23,24,21,0,0,0,0,0,0,0,0,0,0,0,0
16,17,18,15,16,25,128,129,130,131,132,133,134,135,26,24,21,22,23,24,0,0,0,0,0,0,0,0,0,0,0,0
17,18,15,16,27,46,136,137,138,139,140,141,142,143,46,28,24,21,22,23,0,0,0,0,0,0,0,0,0,0,0,0
18,15,16,17,29,46,144,145,146,147,148,149,150,151,46,30,23,24,21,22,0,0,0,0,0,0,0,0,0,0,0,0
15,16,17,18,31,46,152,153,154,155,156,157,158,159,46,32,22,23,24,21,0,0,0,0,0,0,0,0,0,0,0,0
33,34,33,27,35,46,160,161,162,163,164,165,166,167,46,36,28,33,34,33,0,0,0,0,0,0,0,0,0,0,0,0
37,38,39,40,46,46,168,169,170,171,172,173,174,175,46,46,41,37,38,39,0,0,0,0,0,0,0,0,0,0,0,0
37,42,43,44,46,46,176,177,178,179,180,181,182,183,46,46,45,37,42,43,0,0,0,0,0,0,0,0,0,0,0,0
