209,210,210,210,210,210,210,211
212,208,208,208,208,208,208,213
212,208,208,208,208,208,208,213
212,64,65,66,67,68,69,213
212,70,71,72,73,74,75,213
212,76,77,78,79,80,81,213
212,82,83,84,85,86,87,213
212,88,89,90,91,92,93,213
212,94,95,208,208,208,208,213
212,208,208,208,208,208,208,213
212,208,208,208,208,208,208,213
214,215,215,215,215,215,215,216
0,0,0,0,0,0,0,0
0,0,0,0,0,0,0,0
0,0,0,0,0,0,0,0
,