209,210,210,210,210,210,210,211
212,68,108,109,111,208,208,213
212,208,106,239,97,110,208,213
212,208,208,208,208,208,208,213
212,208,112,113,208,208,208,213
212,208,208,208,208,208,208,213
212,208,253,241,208,208,208,213
212,208,208,208,208,208,208,213
214,215,215,215,215,215,215,216
,