209,210,210,210,210,210,210,211
212,208,102,102,102,64,208,213
214,215,215,215,215,215,215,216
209,210,210,210,210,210,210,211
212,224,225,226,64,242,208,213
212,64,245,226,231,232,64,213
212,244,96,97,243,114,233,213
212,64,240,241,109,111,64,213
212,227,228,229,230,241,64,213
212,234,235,236,237,238,110,213
212,208,208,208,208,208,208,213
212,208,112,113,208,208,208,213
212,208,253,241,64,208,208,213
214,215,215,215,215,215,215,216
,