208,208,208,208,208,208,208,208
208,208,112,113,114,115,208,208
208,208,96,97,98,99,118,118
208,208,100,101,102,103,118,119
208,208,100,101,102,103,118,120
208,208,100,101,102,103,118,121
208,208,100,101,102,103,118,122
208,208,100,101,102,103,118,123
208,208,100,101,102,103,118,124
208,208,100,101,102,103,118,125
208,208,100,101,102,103,118,126
208,208,208,208,208,208,208,208

