209,210,210,210,210,210,210,211
212,247,248,66,249,208,208,213
212,208,100,98,94,95,110,213
212,208,208,208,208,208,208,213
212,208,65,93,208,208,208,213
212,208,208,208,208,208,208,213
212,208,93,93,96,208,208,213
212,208,208,208,208,208,208,213
214,215,215,215,215,215,215,216

