209,210,210,210,210,210,210,211
212,208,230,93,90,248,208,213
214,215,215,215,215,215,215,216
209,210,210,210,210,210,210,211
212,94,92,231,208,208,208,213
212,121,79,122,243,79,246,213
212,208,108,228,229,98,94,213
212,208,208,208,208,208,208,213
212,224,225,226,227,100,101,213
212,93,93,92,94,95,110,213
212,208,208,208,208,208,208,213
212,208,65,93,208,208,208,213
212,208,93,93,96,208,208,213
214,215,215,215,215,215,215,216
,