1,2,2,2,2,2,2,2,2,2,2,2,2,2,2,2,2,2,2,3,0,0,0,0,0,0,0,0,0,0,0,0
4,255,255,255,255,255,255,255,255,255,255,255,255,255,255,255,255,255,255,5,0,0,0,0,0,0,0,0,0,0,0,0
4,255,255,255,255,255,255,255,255,255,255,255,255,255,255,255,255,255,255,5,0,0,0,0,0,0,0,0,0,0,0,0
4,255,255,255,255,255,255,255,255,255,255,255,255,255,255,255,255,255,255,5,0,0,0,0,0,0,0,0,0,0,0,0
4,255,255,255,255,255,255,255,255,255,255,255,255,255,255,255,255,255,255,5,0,0,0,0,0,0,0,0,0,0,0,0
6,7,7,7,7,7,7,7,7,7,7,7,7,7,7,7,7,7,7,8,0,0,0,0,0,0,0,0,0,0,0,0
