1,2,2,2,2,2,2,2,2,3,1,2,2,2,2,2,2,2,2,3
4,0,0,0,0,0,0,0,0,5,4,0,0,0,0,0,0,0,0,5
4,0,0,0,0,0,0,0,0,5,4,0,0,0,0,0,0,0,0,5
4,0,0,0,0,0,0,0,0,5,4,0,0,0,0,0,0,0,0,5
4,0,0,0,0,0,0,0,0,5,4,0,0,0,0,0,0,0,0,5
6,7,7,7,7,7,7,7,7,8,6,7,7,7,7,7,7,7,7,8
,