0,0,0,0,0,0,0,0,0,0,0
0,0,0,0,0,0,0,0,0,0,0
0,0,0,0,0,0,0,0,0,0,0
2,2,2,2,2,2,2,2,2,2,3
0,0,0,0,0,0,0,0,0,0,5
0,0,0,0,0,0,0,0,0,0,5
0,0,0,0,0,0,0,0,0,0,5
0,0,0,0,0,0,0,0,0,0,5
7,7,7,7,7,7,7,7,7,7,8
,