191,190,189,188,187,186,185,184
199,198,197,196,195,194,193,192
207,206,205,204,203,202,201,200
215,214,213,212,211,210,209,208
223,222,221,220,219,218,217,216
231,230,229,228,227,226,225,224
239,238,237,236,235,234,233,232
,