0,0,0,0,0,0,0,0,0,0,0,0,0,0,0,0,0,0,0,0,0,0,0,0,0,0,0,0,0,0,0,0
0,0,0,0,0,0,128,129,130,131,132,133,134,135,0,0,0,0,0,0,0,0,32,33,34,35,36,37,38,39,0,0
0,0,0,0,0,0,136,137,138,139,140,141,142,143,0,0,0,0,0,0,0,0,40,41,42,43,44,45,46,47,0,0
0,0,0,0,0,0,144,145,146,147,148,149,150,151,0,0,0,0,0,0,0,0,48,49,50,51,52,53,54,55,0,0
0,0,0,0,0,0,152,153,154,155,156,157,158,159,0,0,0,0,0,0,0,0,56,57,58,59,60,61,62,63,0,0
0,0,0,0,0,0,160,161,162,163,164,165,166,167,0,0,0,0,0,0,0,0,64,65,66,67,68,69,70,71,0,0
0,0,0,0,0,0,168,169,170,171,172,173,174,175,0,0,0,0,0,0,0,0,72,73,74,75,76,77,78,79,0,0
0,0,0,0,0,0,176,177,178,179,180,181,182,183,0,0,0,0,0,0,0,0,80,81,82,83,84,85,86,87,0,0
,