185,186,187,188,189,0,0,0,0,0,0,0,0,0,0,190,191,187,192,193
194,195,196,197,198,0,0,0,0,0,0,0,0,0,0,199,200,201,202,203
187,204,0,0,0,0,0,0,0,0,0,0,0,0,0,0,0,0,205,187
187,206,207,208,0,0,0,0,0,0,0,0,0,0,0,0,209,210,211,187
187,212,213,214,0,0,0,0,0,0,0,0,0,0,0,0,215,216,217,187
187,218,0,0,0,0,0,0,0,0,0,0,0,0,0,0,0,0,219,187
220,221,222,223,224,0,0,0,0,0,0,0,0,0,0,225,226,227,228,229
230,231,187,232,233,0,0,0,0,0,0,0,0,0,0,234,235,187,236,237
,