1,2,2,2,2,2,2,2,2,2,3
4,0,64,65,66,67,68,69,70,71,5
4,0,0,0,0,0,0,0,0,0,5
4,0,72,73,74,75,76,77,78,79,5
4,0,0,0,0,0,0,0,0,0,5
4,0,80,81,82,83,84,85,86,87,5
4,0,0,0,0,0,0,0,0,0,5
4,0,88,89,90,91,92,93,94,95,5
9,7,7,7,7,7,7,7,7,7,8
