66,67,68,72,73,74,75,69,70,71
84,0,0,76,77,78,79,0,0,85
84,86,86,80,81,82,83,86,86,85
87,0,0,0,0,0,0,0,0,88
87,191,190,189,188,187,186,185,184,88
87,199,198,197,196,195,194,193,192,88
87,207,206,205,204,203,202,201,200,88
87,215,214,213,212,211,210,209,208,88
87,223,222,221,220,219,218,217,216,88
87,231,230,229,228,227,226,225,224,88
87,239,238,237,236,235,234,233,232,88
87,32,33,34,35,36,37,38,39,88
,