0,0,0,0,0,0,0,0
64,65,66,67,68,69,70,71
0,0,0,0,0,0,0,0
0,0,0,0,0,0,0,0
72,73,74,75,76,77,78,79
0,0,0,0,0,0,0,0
0,0,0,0,0,0,0,0
0,0,0,0,0,0,0,0
0,0,0,0,0,0,0,0
