0,0,0,0,0,0,0,0
64,65,66,67,68,69,70,71
57,58,0,0,59,60,0,0
0,0,0,0,0,0,0,0
72,73,74,75,76,77,78,79
57,58,0,0,59,60,0,0
0,0,0,0,0,0,0,0
80,81,82,83,84,85,86,87
57,58,0,0,59,60,0,0
