135,134,133,132,131,130,129,128
143,142,141,140,139,138,137,136
151,150,149,148,147,146,145,144
159,158,157,156,155,154,153,152
167,166,165,164,163,162,161,160
175,174,173,172,171,170,169,168
183,182,181,180,179,178,177,176
,