1,2,2,2,2,2,2,2,2,3
4,0,0,0,0,0,0,0,0,5
4,14,15,0,0,0,0,0,0,5
4,0,0,0,0,0,0,0,0,5
4,10,11,0,0,0,0,0,0,5
4,0,0,0,0,0,0,0,0,5
4,0,0,0,0,0,0,0,0,5
4,64,65,66,67,0,0,0,0,5
4,0,0,0,0,0,0,0,0,5
4,68,69,70,71,0,0,0,0,5
4,0,0,0,0,0,0,0,0,5
4,72,73,74,75,0,0,0,0,5
4,0,0,0,0,0,0,0,0,5
4,76,77,78,79,0,0,0,0,5
4,0,0,0,0,0,0,0,0,5
4,80,81,82,83,0,0,0,0,5
4,0,0,0,0,0,0,0,0,5
9,7,7,7,7,7,7,7,7,8

