185,184,184,184,184,184,184,184,184,184,184,184,184,184,184,184,184,184,184,186
187,188,189,190,191,184,184,184,184,184,184,184,184,184,184,192,193,194,195,196
197,198,199,200,201,202,184,184,184,184,184,184,184,184,203,204,205,199,206,207
197,198,208,209,210,202,184,184,184,184,184,184,184,184,203,211,212,213,206,207
197,214,215,216,217,202,184,184,184,184,184,184,184,184,203,218,219,220,206,207
197,221,222,223,224,202,184,184,184,184,184,184,184,184,203,225,226,222,206,207
197,227,228,229,230,184,184,184,184,184,184,184,184,184,184,231,232,233,234,207
235,184,184,184,184,184,184,184,184,184,184,184,184,184,184,184,184,184,184,236
,