130,131,132,136,137,138,139,133,134,135
148,128,128,140,141,142,143,128,128,149
148,150,150,144,145,146,147,150,150,149
151,48,0,0,0,0,0,0,0,152
151,49,0,0,0,0,0,0,0,152
151,191,190,189,188,187,186,185,184,152
151,199,198,197,196,195,194,193,192,152
151,207,206,205,204,203,202,201,200,152
151,215,214,213,212,211,210,209,208,152
151,223,222,221,220,219,218,217,216,152
151,231,230,229,228,227,226,225,224,152
151,239,238,237,236,235,234,233,232,152

