0,1,2,3,4,0,0,0,0,0,0,0,5,6,7,8,0,0,0,0,0,0,0,0,0,0,0,0,0,0,0,0
0,9,10,11,12,13,14,15,0,0,0,16,17,18,19,20,21,0,0,22,0,0,0,0,0,0,0,0,0,0,0,0
0,23,24,25,11,11,11,26,27,28,29,30,31,32,33,34,35,36,37,38,0,0,0,0,0,0,0,0,0,0,0,0
0,0,39,40,41,11,11,11,42,11,43,44,45,46,47,48,49,50,51,52,0,0,0,0,0,0,0,0,0,0,0,0
0,0,53,54,55,11,11,11,11,56,57,58,59,60,61,62,63,64,65,66,0,0,0,0,0,0,0,0,0,0,0,0
0,67,68,69,70,71,72,73,11,74,75,76,77,78,79,80,81,82,83,84,0,0,0,0,0,0,0,0,0,0,0,0
0,85,86,87,88,89,90,91,92,93,94,11,95,96,97,98,99,100,101,102,0,0,0,0,0,0,0,0,0,0,0,0
0,103,104,105,106,107,108,109,110,111,112,11,11,113,114,115,116,117,118,119,0,0,0,0,0,0,0,0,0,0,0,0
0,120,121,122,123,124,125,126,127,111,128,11,11,129,130,131,132,133,134,135,0,0,0,0,0,0,0,0,0,0,0,0
0,136,137,138,139,140,141,142,143,144,145,146,147,148,149,150,151,152,153,154,0,0,0,0,0,0,0,0,0,0,0,0
0,155,156,157,158,159,0,160,161,162,163,164,165,166,167,168,169,170,171,172,0,0,0,0,0,0,0,0,0,0,0,0
0,173,174,175,176,177,178,179,180,181,182,183,184,185,186,187,188,189,190,191,0,0,0,0,0,0,0,0,0,0,0,0
0,0,192,193,194,195,196,197,198,199,200,201,202,203,204,205,206,207,208,209,0,0,0,0,0,0,0,0,0,0,0,0
0,0,210,211,212,213,214,215,216,217,218,219,220,221,222,223,223,224,225,226,0,0,0,0,0,0,0,0,0,0,0,0
0,0,0,227,228,229,230,231,232,111,233,234,235,236,237,238,223,223,239,240,0,0,0,0,0,0,0,0,0,0,0,0
223,223,223,223,223,223,223,223,223,223,223,223,223,223,223,223,223,223,223,223,0,0,0,0,0,0,0,0,0,0,0,0
223,223,223,223,223,223,223,223,223,223,223,223,223,223,223,223,223,223,223,223,0,0,0,0,0,0,0,0,0,0,0,0
223,223,223,223,223,223,223,223,223,223,223,223,223,223,223,223,223,223,223,223,0,0,0,0,0,0,0,0,0,0,0,0
223,223,223,223,223,223,223,223,223,223,223,223,223,223,223,223,223,223,223,223,0,0,0,0,0,0,0,0,0,0,0,0
223,223,223,223,223,223,223,223,223,223,223,223,223,223,223,223,223,223,223,223,0,0,0,0,0,0,0,0,0,0,0,0
