1,1,1,1,1,1,1,1,1,1,1,1,1,1,1,1,1,1,1,1,1,1,1,1,1,1,1,1,1,1,1,1
1,1,1,1,1,1,1,1,1,1,1,1,1,1,1,1,1,1,1,1,1,1,1,1,1,1,1,1,1,1,1,1
1,1,1,1,1,1,1,1,1,1,1,1,1,1,1,1,1,1,1,1,1,1,1,1,1,1,1,1,1,1,1,1
2,3,4,5,6,7,8,9,10,11,12,13,14,15,0,0,0,0,0,0,0,0,0,0,0,0,0,0,0,0,0,0
16,17,18,19,20,21,22,23,24,25,26,27,28,29,30,0,0,0,0,0,0,0,0,0,0,0,0,0,0,0,0,0
31,32,33,34,35,36,37,38,39,40,41,42,43,44,45,0,0,0,0,0,0,0,0,0,0,0,0,0,0,0,0,0
46,42,47,48,49,50,51,52,53,54,55,56,57,58,59,0,0,0,0,0,0,0,0,0,0,0,0,0,0,0,0,0
60,61,62,63,64,65,66,67,68,69,70,71,72,73,74,0,0,0,0,0,0,0,0,0,0,0,0,0,0,0,0,0
75,76,77,78,79,80,81,82,83,84,85,86,87,88,146,0,0,0,0,0,0,0,0,0,0,0,0,0,0,0,0,0
89,90,91,92,93,94,95,96,97,98,99,100,101,102,147,0,0,0,0,0,0,0,0,0,0,0,0,0,0,0,0,0
103,104,105,106,107,108,109,110,111,112,113,114,115,148,0,0,0,0,0,0,0,0,0,0,0,0,0,0,0,0,0,0
116,117,118,119,120,121,122,123,124,125,126,127,128,149,0,0,0,0,0,0,0,0,0,0,0,0,0,0,0,0,0,0
129,19,19,19,130,131,132,133,134,135,136,137,138,139,0,0,0,0,0,0,0,0,0,0,0,0,0,0,0,0,0,0
19,19,19,19,19,140,141,19,142,143,144,145,0,0,0,0,0,0,0,0,0,0,0,0,0,0,0,0,0,0,0,0
1,1,1,1,1,1,1,1,1,1,1,1,1,1,1,1,1,1,1,1,1,1,1,1,1,1,1,1,1,1,1,1
1,1,1,1,1,1,1,1,1,1,1,1,1,1,1,1,1,1,1,1,1,1,1,1,1,1,1,1,1,1,1,1
1,1,1,1,1,1,1,1,1,1,1,1,1,1,1,1,1,1,1,1,1,1,1,1,1,1,1,1,1,1,1,1
1,1,1,1,1,1,1,1,1,1,1,1,1,1,1,1,1,1,1,1,1,1,1,1,1,1,1,1,1,1,1,1
1,1,1,1,1,1,1,1,1,1,1,1,1,1,1,1,1,1,1,1,1,1,1,1,1,1,1,1,1,1,1,1
1,1,1,1,1,1,1,1,1,1,1,1,1,1,1,1,1,1,1,1,1,1,1,1,1,1,1,1,1,1,1,1
